#############################
#S..#..E..........#.###.....#
###.#.##.###E####.#.####.##.#
###T#.#T.###E####.....##.##.#
###..E#.####T########.#..##.#
#.###############........##.#
#......G#.........#########.#
#.#####################...#.#
#...#..E.........#....#.#.#.#
#.#.#.##.###E.##.#..###.#.#.#
#.#T#.#T.###E.##....###.#.#.#
#.#..E#.##..T.#######.#.#.#.#
#.#....E.#..#...........#...#
#############################