##############
#S.##TTEE...EG
##..#TT##..###
###.T###T.####
####..#..#####
#####.E.######
##############