##############
#S.....ETE..E#
#.....ETE..ET#
#....ETE....E#
#.....EE.....#
#.....EEE....#
#######G######