##############
#S..#..E.....#
###.#.##.###E#
###T#.#T.###E#
###..E#.####T#
#######E######
#######G######