##############
#S.....T.....#
############E#
#......T.....#
#E##########E#
#......T..E#T#
##########G###